ASV	"1901 American Standard Version"
KJV	"King James Version of 1611 w/ Strongs Numbers"
BBE	"1965 Bible in Basic English"
Websters	"The Webster Bible"
RWebster	"Revised 1833 Webster Version (RWEBSTER)"
Weymouth	"1912 Weymouth NT"
ORTHJBC	"The Orthodox Jewish Brit Chadasha"
Rotherham	"The Emphasized Bible by J. B. Rotherham"
YLT	"1898 Young's Literal Translation"
ISV	"International Standard Version"
Darby	"1889 Darby Bible"
AKJV	"American King James Version"
RNKJV	"Restored Name King James Version"
WEB	"The World English Bible"
HNV	"The Hebrew Names Version of the World English Bible"
DRA	"The Douay-Rheims 1899 American Edition"
LO	"The Living Oracles NT"
DR	"Douay-Rheims Bible"
Murdock	"James Murdock's Translation of the Syriac Peshitta"
JPS	"Jewish Publication Society Old Testament"
Twenty	"The Twentieth Century New Testament"
Montgomery	"Montgomery New Testament"
Byz	"1991 Byzantine/Majority Text"
ByzX	"1991 Byzantine/Majority Text - Roman Transliterated"
LXX	"Septuagint (LXX)"
LXXX	"Septuagint (LXX) - Roman Transliterated"
IGNT	"Interlinear Greek New Testament"
Tisch	"Tischendorf's Eighth Edition GNT"
UMGreek	"Unaccented Modern Greek Text"
Stephanus	"1550 Stephanus Textus Receptus"
StephanusX	"1550 Stephanus Textus Receptus - Roman Transliterated"
WH	"1881 Westcott-Hort Greek Text"
WHNU	"Westcott-Hort with NA27U4 variants"
Scrivner	"1894 Scrivener Textus Receptus"
ScrivnerX	"1894 Scrivener Textus Receptus - Roman Transliterated"
Vulgate	"Latin Vulgate"
Vulgate_HebPs	"Latin Vulgate Psalms from Hebrew"
GerSch	"German 1951 Schlachter Bibel"
GerLut	"German 1912 Luther"
GerBen	"German Bengel NT"
GerLut1545	"German 1545 Luther"
Dan	"Danske Bibel (Danish Bible)"
Icelandic	"Icelandic Bible"
FinPR	"Finnish 1938 Phy Raamattu"
SweSVE	"Swedish Bible 1917 New Testament"
Norsk	"Norsk (Norwegian) Bible"
ManxGaelic	"Gaelic Scripture Portions"
ScotsGaelic	"Gaelic Gospel of Mark"
Turkish	"Turkish NT"
RomCor	"Romanian Cornilescu Version"
CzeNKB	"Nova kralicka Bible"
CzeKMS	"Preklad KMS Nova smlouva"
CzeBKR	"Czech Bible Kralicka"
CzeCEP	"Czech Ekumenicky Cesky preklad"
HunKar	"Hungarian Karoli"
Swahili	"Swahili New Testament"
ChiGU-B5	"Chinese Glory Union Bible (Big5)"
ChiGU-UTF8	"Chinese Glory Union Bible (UTF8)"
ChiGU-GB	"Chinese Glory Union Bible (GB2312)"
Viet	"1934 Vietnamese Bible"
Korean	"Korean Bible"
Maori	"Maori Bible"
IndTB	"Indonesian Terjemahan Baru"
IndBIS	"Indonesian Bahasa Indonesia Sehari-hari"
IndTL	"Indonesian Terjemahan Baru"
ArabicLtoR	"Arabic Bible - Left to Right"
Arabic	"Arabic Bible"
ItaLND	"Italian 1991 La Nuova Diodati"
ItaNRV	"Italian 1994 La Sacra Bibbia Nuova Riveduta"
SpaSEV	"Spanish 1569 Sagradas Escrituras Version Antigua"
SpaRV	"Spanish Reina-Valera"
SpaVNT	"Spanish Valera 1858 Spanish New Testament Text"
Esperanto	"Esperanto Bible"
FreLSG	"French 1910 Louis Segond"
FreCrl	"French Haitian Creole Version"
Uma	"Uma New Testament"
Mel	"Melanesian Pidgin Bible"
Latvian	"Latvian New Testament"
Xhosa	"Xhosa Bible"
Tagalog	"Tagalog (John & James)"
Ketchi	"Ketchi Bible"
GothicA	"Gothic Codex Ambr. A & Mss."
GothicB	"Gothic Codex Ambr. B & Car."
